"filename", "language", "CSS", "JavaScript", "XML", "JSON", "comment", "blank", "total"
"/home/manuareraa/Personal/github/personal/geia/apps/geoblocs-frontend/src/App.css", "CSS", 88, 0, 0, 0, 5, 16, 109
"/home/manuareraa/Personal/github/personal/geia/apps/geoblocs-frontend/src/App.js", "JavaScript", 0, 215, 0, 0, 1, 7, 223
"/home/manuareraa/Personal/github/personal/geia/apps/geoblocs-frontend/src/AppContext.js", "JavaScript", 0, 1248, 0, 0, 27, 68, 1343
"/home/manuareraa/Personal/github/personal/geia/apps/geoblocs-frontend/src/Geoblocs.js", "JavaScript", 0, 5, 0, 0, 0, 3, 8
"/home/manuareraa/Personal/github/personal/geia/apps/geoblocs-frontend/src/accountDets.json", "JSON", 0, 0, 0, 17, 0, 1, 18
"/home/manuareraa/Personal/github/personal/geia/apps/geoblocs-frontend/src/assets/svg/add.svg", "XML", 0, 0, 3, 0, 0, 1, 4
"/home/manuareraa/Personal/github/personal/geia/apps/geoblocs-frontend/src/assets/svg/admin-logo.svg", "XML", 0, 0, 3, 0, 0, 1, 4
"/home/manuareraa/Personal/github/personal/geia/apps/geoblocs-frontend/src/assets/svg/back-circle.svg", "XML", 0, 0, 4, 0, 0, 1, 5
"/home/manuareraa/Personal/github/personal/geia/apps/geoblocs-frontend/src/assets/svg/baseline.svg", "XML", 0, 0, 4, 0, 0, 1, 5
"/home/manuareraa/Personal/github/personal/geia/apps/geoblocs-frontend/src/assets/svg/buyers.svg", "XML", 0, 0, 7, 0, 0, 1, 8
"/home/manuareraa/Personal/github/personal/geia/apps/geoblocs-frontend/src/assets/svg/community-centric.svg", "XML", 0, 0, 4, 0, 0, 1, 5
"/home/manuareraa/Personal/github/personal/geia/apps/geoblocs-frontend/src/assets/svg/decentralization.svg", "XML", 0, 0, 6, 0, 0, 1, 7
"/home/manuareraa/Personal/github/personal/geia/apps/geoblocs-frontend/src/assets/svg/document.svg", "XML", 0, 0, 4, 0, 0, 1, 5
"/home/manuareraa/Personal/github/personal/geia/apps/geoblocs-frontend/src/assets/svg/edit.svg", "XML", 0, 0, 4, 0, 0, 1, 5
"/home/manuareraa/Personal/github/personal/geia/apps/geoblocs-frontend/src/assets/svg/efficiency-technology.svg", "XML", 0, 0, 5, 0, 0, 1, 6
"/home/manuareraa/Personal/github/personal/geia/apps/geoblocs-frontend/src/assets/svg/environment-icon.svg", "XML", 0, 0, 9, 0, 0, 1, 10
"/home/manuareraa/Personal/github/personal/geia/apps/geoblocs-frontend/src/assets/svg/fb.svg", "XML", 0, 0, 3, 0, 0, 1, 4
"/home/manuareraa/Personal/github/personal/geia/apps/geoblocs-frontend/src/assets/svg/file-upload.svg", "XML", 0, 0, 5, 0, 0, 1, 6
"/home/manuareraa/Personal/github/personal/geia/apps/geoblocs-frontend/src/assets/svg/flow-dots.svg", "XML", 0, 0, 21, 0, 0, 1, 22
"/home/manuareraa/Personal/github/personal/geia/apps/geoblocs-frontend/src/assets/svg/health.svg", "XML", 0, 0, 4, 0, 0, 1, 5
"/home/manuareraa/Personal/github/personal/geia/apps/geoblocs-frontend/src/assets/svg/insta.svg", "XML", 0, 0, 3, 0, 0, 1, 4
"/home/manuareraa/Personal/github/personal/geia/apps/geoblocs-frontend/src/assets/svg/linkedin.svg", "XML", 0, 0, 3, 0, 0, 1, 4
"/home/manuareraa/Personal/github/personal/geia/apps/geoblocs-frontend/src/assets/svg/loading.svg", "XML", 0, 0, 10, 0, 0, 0, 10
"/home/manuareraa/Personal/github/personal/geia/apps/geoblocs-frontend/src/assets/svg/location.svg", "XML", 0, 0, 4, 0, 0, 1, 5
"/home/manuareraa/Personal/github/personal/geia/apps/geoblocs-frontend/src/assets/svg/management.svg", "XML", 0, 0, 4, 0, 0, 1, 5
"/home/manuareraa/Personal/github/personal/geia/apps/geoblocs-frontend/src/assets/svg/maximize.svg", "XML", 0, 0, 3, 0, 0, 1, 4
"/home/manuareraa/Personal/github/personal/geia/apps/geoblocs-frontend/src/assets/svg/monitor.svg", "XML", 0, 0, 5, 0, 0, 1, 6
"/home/manuareraa/Personal/github/personal/geia/apps/geoblocs-frontend/src/assets/svg/monitoring-icon.svg", "XML", 0, 0, 9, 0, 0, 1, 10
"/home/manuareraa/Personal/github/personal/geia/apps/geoblocs-frontend/src/assets/svg/paid-restore.svg", "XML", 0, 0, 6, 0, 0, 1, 7
"/home/manuareraa/Personal/github/personal/geia/apps/geoblocs-frontend/src/assets/svg/purchase-geoblocs.svg", "XML", 0, 0, 5, 0, 0, 1, 6
"/home/manuareraa/Personal/github/personal/geia/apps/geoblocs-frontend/src/assets/svg/radical-transparency.svg", "XML", 0, 0, 6, 0, 0, 1, 7
"/home/manuareraa/Personal/github/personal/geia/apps/geoblocs-frontend/src/assets/svg/register-project.svg", "XML", 0, 0, 4, 0, 0, 1, 5
"/home/manuareraa/Personal/github/personal/geia/apps/geoblocs-frontend/src/assets/svg/register.svg", "XML", 0, 0, 3, 0, 0, 1, 4
"/home/manuareraa/Personal/github/personal/geia/apps/geoblocs-frontend/src/assets/svg/right-arrow-b.svg", "XML", 0, 0, 3, 0, 0, 1, 4
"/home/manuareraa/Personal/github/personal/geia/apps/geoblocs-frontend/src/assets/svg/right-arrow-g.svg", "XML", 0, 0, 3, 0, 0, 1, 4
"/home/manuareraa/Personal/github/personal/geia/apps/geoblocs-frontend/src/assets/svg/right-arrow.svg", "XML", 0, 0, 3, 0, 0, 1, 4
"/home/manuareraa/Personal/github/personal/geia/apps/geoblocs-frontend/src/assets/svg/scientists.svg", "XML", 0, 0, 4, 0, 0, 1, 5
"/home/manuareraa/Personal/github/personal/geia/apps/geoblocs-frontend/src/assets/svg/season-icon.svg", "XML", 0, 0, 9, 0, 0, 1, 10
"/home/manuareraa/Personal/github/personal/geia/apps/geoblocs-frontend/src/assets/svg/sell.svg", "XML", 0, 0, 4, 0, 0, 1, 5
"/home/manuareraa/Personal/github/personal/geia/apps/geoblocs-frontend/src/assets/svg/share.svg", "XML", 0, 0, 3, 0, 0, 1, 4
"/home/manuareraa/Personal/github/personal/geia/apps/geoblocs-frontend/src/assets/svg/shield.svg", "XML", 0, 0, 4, 0, 0, 1, 5
"/home/manuareraa/Personal/github/personal/geia/apps/geoblocs-frontend/src/assets/svg/sponsors-icon.svg", "XML", 0, 0, 9, 0, 0, 1, 10
"/home/manuareraa/Personal/github/personal/geia/apps/geoblocs-frontend/src/assets/svg/stewards.svg", "XML", 0, 0, 5, 0, 0, 1, 6
"/home/manuareraa/Personal/github/personal/geia/apps/geoblocs-frontend/src/assets/svg/streamlined-process.svg", "XML", 0, 0, 4, 0, 0, 1, 5
"/home/manuareraa/Personal/github/personal/geia/apps/geoblocs-frontend/src/assets/svg/wallet.svg", "XML", 0, 0, 4, 0, 0, 1, 5
"/home/manuareraa/Personal/github/personal/geia/apps/geoblocs-frontend/src/components/Footer.js", "JavaScript", 0, 38, 0, 0, 0, 5, 43
"/home/manuareraa/Personal/github/personal/geia/apps/geoblocs-frontend/src/components/Loading.js", "JavaScript", 0, 16, 0, 0, 0, 4, 20
"/home/manuareraa/Personal/github/personal/geia/apps/geoblocs-frontend/src/components/Navbar.js", "JavaScript", 0, 111, 0, 0, 1, 6, 118
"/home/manuareraa/Personal/github/personal/geia/apps/geoblocs-frontend/src/components/Tester.js", "JavaScript", 0, 9, 0, 0, 0, 2, 11
"/home/manuareraa/Personal/github/personal/geia/apps/geoblocs-frontend/src/components/Transition.js", "JavaScript", 0, 17, 0, 0, 0, 5, 22
"/home/manuareraa/Personal/github/personal/geia/apps/geoblocs-frontend/src/components/admin/ButtonsContainer.js", "JavaScript", 0, 38, 0, 0, 0, 3, 41
"/home/manuareraa/Personal/github/personal/geia/apps/geoblocs-frontend/src/components/admin/GeoblocsChart.js", "JavaScript", 0, 137, 0, 0, 5, 12, 154
"/home/manuareraa/Personal/github/personal/geia/apps/geoblocs-frontend/src/components/admin/StatusChart.js", "JavaScript", 0, 114, 0, 0, 4, 7, 125
"/home/manuareraa/Personal/github/personal/geia/apps/geoblocs-frontend/src/components/admin/project-view/ManageGeoblocs.js", "JavaScript", 0, 293, 0, 0, 11, 14, 318
"/home/manuareraa/Personal/github/personal/geia/apps/geoblocs-frontend/src/components/admin/project-view/ProjectConditions.js", "JavaScript", 0, 128, 0, 0, 0, 11, 139
"/home/manuareraa/Personal/github/personal/geia/apps/geoblocs-frontend/src/components/admin/project-view/ProjectDocuments.js", "JavaScript", 0, 154, 0, 0, 0, 13, 167
"/home/manuareraa/Personal/github/personal/geia/apps/geoblocs-frontend/src/components/admin/project-view/ProjectEnvironment.js", "JavaScript", 0, 107, 0, 0, 0, 11, 118
"/home/manuareraa/Personal/github/personal/geia/apps/geoblocs-frontend/src/components/admin/project-view/ProjectGallery.js", "JavaScript", 0, 107, 0, 0, 12, 10, 129
"/home/manuareraa/Personal/github/personal/geia/apps/geoblocs-frontend/src/components/admin/project-view/ProjectLinks.js", "JavaScript", 0, 123, 0, 0, 0, 12, 135
"/home/manuareraa/Personal/github/personal/geia/apps/geoblocs-frontend/src/components/admin/project-view/ProjectMetadata.js", "JavaScript", 0, 219, 0, 0, 0, 13, 232
"/home/manuareraa/Personal/github/personal/geia/apps/geoblocs-frontend/src/components/admin/project-view/ProjectSeasons.js", "JavaScript", 0, 167, 0, 0, 0, 14, 181
"/home/manuareraa/Personal/github/personal/geia/apps/geoblocs-frontend/src/components/admin/project-view/ProjectSponsors.js", "JavaScript", 0, 170, 0, 0, 0, 14, 184
"/home/manuareraa/Personal/github/personal/geia/apps/geoblocs-frontend/src/components/admin/project-view/ProjectStory.js", "JavaScript", 0, 140, 0, 0, 0, 12, 152
"/home/manuareraa/Personal/github/personal/geia/apps/geoblocs-frontend/src/components/stakeholders/Buyers.js", "JavaScript", 0, 98, 0, 0, 0, 10, 108
"/home/manuareraa/Personal/github/personal/geia/apps/geoblocs-frontend/src/components/stakeholders/LandStewards.js", "JavaScript", 0, 208, 0, 0, 0, 28, 236
"/home/manuareraa/Personal/github/personal/geia/apps/geoblocs-frontend/src/components/stakeholders/Scientists.js", "JavaScript", 0, 36, 0, 0, 0, 7, 43
"/home/manuareraa/Personal/github/personal/geia/apps/geoblocs-frontend/src/index.css", "CSS", 21, 0, 0, 0, 4, 6, 31
"/home/manuareraa/Personal/github/personal/geia/apps/geoblocs-frontend/src/index.js", "JavaScript", 0, 13, 0, 0, 0, 2, 15
"Total", "-", 109, 3911, 206, 17, 70, 355, 4668